{
  "maze": [
    ["W", "V", "V", "V", "V", "V", "V", "V", "V", "V", "V", "V", "V", "V", "V", "V", "V", "V", "V", "W"],
    ["W", "S", "S", "S", "S", "S", "S", "S", "S", "B", "S", "B", "S", "S", "S", "S", "S", "S", "S", "W"],
    ["W", "S", "B", "S", "S", "S", "S", "S", "S", "B", "B", "B", "S", "S", "S", "S", "S", "S", "S", "W"],
    ["W", "S", "B", "S", "S", "B", "S", "S", "S", "B", "B", "B", "S", "S", "S", "S", "S", "S", "S", "W"],
    ["W", "S", "B", "S", "S", "B", "S", "S", "S", "S", "S", "S", "B", "S", "S", "S", "S", "S", "S", "W"],
    ["W", "S", "B", "S", "S", "B", "S", "S", "B", "T", "T", "S", "S", "S", "B", "S", "S", "S", "S", "W"],
    ["W", "S", "B", "S", "S", "B", "S", "S", "S", "S", "S", "S", "S", "S", "B", "S", "S", "S", "S", "W"],
    ["W", "S", "B", "S", "S", "B", "S", "S", "S", "S", "S", "S", "S", "S", "B", "S", "S", "S", "S", "W"],
    ["W", "S", "S", "S", "S", "S", "S", "S", "S", "S", "S", "S", "S", "S", "B", "S", "S", "S", "S", "W"],
    ["W", "S", "B", "B", "S", "S", "S", "B", "B", "B", "B", "B", "S", "S", "B", "S", "S", "B", "B", "W"],
    ["W", "S", "S", "S", "S", "S", "S", "S", "S", "S", "S", "S", "S", "S", "B", "B", "B", "B", "S", "W"],
    ["W", "S", "B", "S", "S", "B", "S", "S", "S", "S", "S", "S", "S", "S", "S", "S", "S", "S", "S", "W"],
    ["W", "S", "B", "S", "S", "B", "S", "S", "S", "S", "S", "S", "S", "S", "S", "S", "S", "S", "S", "W"],
    ["W", "S", "B", "S", "S", "B", "S", "S", "B", "B", "B", "S", "S", "S", "S", "S", "S", "S", "S", "W"],
    ["W", "S", "B", "S", "S", "B", "S", "S", "S", "S", "S", "S", "S", "B", "B", "B", "B", "B", "S", "W"],
    ["W", "S", "B", "S", "S", "B", "S", "S", "S", "S", "S", "S", "S", "S", "S", "S", "S", "S", "S", "W"],
    ["W", "S", "S", "S", "S", "S", "S", "S", "S", "S", "S", "S", "S", "S", "S", "S", "S", "S", "S", "W"],
    ["W", "S", "S", "S", "S", "S", "S", "S", "S", "S", "S", "S", "S", "S", "S", "S", "S", "S", "S", "W"],
    ["W", "S", "S", "S", "S", "S", "S", "S", "S", "S", "S", "S", "S", "S", "S", "S", "S", "S", "S", "W"],
    ["W", "V", "V", "V", "V", "V", "V", "V", "V", "V", "V", "V", "V", "V", "V", "V", "V", "V", "V", "W"]
    ]
}
/* W:WALL HOR
 * V:WALL VECT
 * S:SOL
 * J:JOUEUR
 * B:BIRQUES×©
 * F:FERÌúclass.forname
 * T:TREE
 * */
